$ANSIBLE_VAULT;1.1;AES256
35623930323838366366333764646462633134326238646139383932336666616637623164366461
6661396339363536326166336138393265613630323066350a326335363866306165626132396362
61383330323062396661653336326335396234383561383762613737316362373234363130633737
3535356632653636350a393564646564333462666638653631633163353235386366303861656233
38303236333363613966376533386665643730313764313731333836613662303131626636636638
33633930666661373336356338666361623065396466653062393331316461386137373330613366
303362306131643838636563616435353835
